{
    "groundTextureUrl": "./textures/ground.jpg",
    "wallTextureUrl": "./textures/wall.jpg",
    "size": { "width": 10, "height": 10 },
    "map": [
        [2, 2, 2, 0, 0, 2, 2, 2, 0, 2, 2],
    [1, 0, 1, 0, 0, 1, 0, 1, 0, 1, 1],
    [1, 0, 1, 0, 0, 1, 0, 1, 0, 1, 1],
    [1, 0, 1, 0, 0, 1, 0, 1, 0, 1, 1],
    [2, 2, 3, 0, 0, 2, 2, 2, 0, 2, 2],
    [0, 0, 0, 0, 0, 0, 0, 0, 0, 0, 0],
    [2, 2, 2, 0, 2, 2, 2, 0, 0, 2, 2],
    [1, 0, 1, 0, 1, 0, 1, 0, 0, 1, 1],
    [1, 0, 1, 0, 1, 0, 1, 0, 0, 1, 1],
    [1, 0, 1, 0, 1, 0, 1, 0, 0, 1, 1],
    [2, 2, 3, 0, 2, 2, 2, 0, 0, 2, 2]
    ],
    "initialPosition": [7, 6],
    "initialDirection": 0.0,
    "exitLocation": [-0.5, 6]
}